7 8
3 6
B W W W W W B
W F F F F F W
W F T S T F W
W F S T S F W
W F T S T F W
W F S T S F W
W F F F F F W
B W W W W W B